X,X,X,X,X,X,X,X,X,X,X,X,X,X,X
X, , , , , , , , , , , , , ,X
X, , , , , , , , , , , , , ,X
X, , , , , , ,H, , , , , , ,X
X, , , , , , , , , , , , , ,X
X, , ,H, ,B, , , , , , , , ,X
X, , , , , , ,B, , , , , , ,X
X, , , , , , , , , , , , , ,X
X, , , , , , ,A, , , , , , ,X
X, , , , , , , , , , , , , ,X
X, , , , , , , , , , , , , ,X
X, , , , , , , , , , , , , ,X
X, , , , , , , , , , , , , ,X
X, , , , , , , , , , , , , ,X
X,X,X,X,X,X,X,X,X,X,X,X,X,X,X